-100 -100 -100 -100 -100 -100 -100 -100 -100 -100 -100 -100 -100
-100    10   0    0    0    0    0    0    0    0    0    0 -100
-100    0    0    0    0    0    0    0    0    0    0    0 -100
-100    0    0    0    0    0    0    0    0    0    0    0 -100
-100    0    0    0    0    0    0    0    0    0    0    0 -100
-100    0    0    0    0    0    0    0    0    0    0    0 -100
-100    0    0    0    0    0    0    0    0    0    0    0 -100
-100    0    0    0    0    0    0    0    0    0    0    0 -100
-100 -100 -100 -100 -100 -100 -100 -100 -100 -100 -100 -100 -100
